#########
#       #
#   @   #
#   +   #
#       #
#########