#########
#       #
#   @  *#
#   +   #
#%  ?   #
#########